WWWWWWWWWWWWWWWWW
W-------1-------W
W-W-W-W-W-W-W-W-W
W-------O-------W
W-W-W-W-W-W-W-W-W
W-------O-------W
W-W-WOWOWOWOW-W-W
W-------O-------W
W-W-W-W-W-W-W-W-W
W-----R-O-------W
W-W-W-W-W-W-W-W-W
W---------------W
WWWWWWWWWWWWWWWWW