WWWWWWWWWWWWWWWWW
W-------1-------W
W-W-W-W-W-W-W-W-W
W-------O-------W
W-W-W-W-W-W-W-W-W
W-------O------3W
W-W-WOWOWOWOW-W-W
W-------O-------W
W-W-W-W-W-W-W-W-W
W-----R-O-------W
W-W-W-W-W-W-W-W-W
W--------------2W
WWWWWWWWWWWWWWWWW